11111111111111
1PC10000000C01
1000C11111C001
1C0011E0000001
11111111111111
