1111111111111
1P010000100C1
1000011111001
100011E000001
1111111111111
