1111111111
1C10C001P1
1010100101
100C100001
1001100001
1C011C1001
1011000101
10C10111C1
1011000001
10C11E0111
10011100C1
1111111111