1111111111111111
1C10C001P00000C1
1010100101011111
100C100001000001
1001100001111101
1C011C1001C00101
1011000101110101
10C10111C1000101
1011000001011101
10C11E011101C001
10011100C001C001
1111111111111111