1111111111111111
1CM0C001P00000C1
10B01001010BBBB1
100C10M001000001
100B100001111101
1C0C1C1001C00M01
101M000101110M01
10CM0111C1000M01
101M000001011101
10B11E0BBB01C001
10011100C001C001
1111111111111111