11111111111111
1P0M0000000C01
10000MMMMM0M01
100011E0000MC1
11111111111111