11111111111111
1P010000000C01
10000111110M01
100011E0000001
10000000000001
11111111111101
10000000000001
10111111111111
10000000000001
11111111111111