11111111111111
1P010000000C01
10000MM1MM0M01
100011E0000MC1
11111111111111